######################
#A      #            #
# #### ## #########  #
# #  #  #         #  #
# # ## # ######### # #
# # ## #           # #
# #    ############# #
# ######             #
#                    #
# ######### ##########
#         #          #
####################B#
