##########
#A       #
# #### # #
#    # #B#
# #### ###
#        #
##########
